9,9,9,9,9,9,9,9,9,9,9,9,9,9,9,9,9,9,9,9,9,9,9,9,9,9,9,9,9,9,
9,9,9,9,9,9,9,9,9,9,9,9,9,9,9,9,9,9,9,9,9,9,9,9,9,9,9,9,9,9,
9,9,9,9,9,9,9,9,9,9,9,9,9,9,9,9,9,9,9,9,9,9,9,9,9,9,9,9,9,9,
9,9,9,9,9,9,9,9,9,9,9,9,9,9,9,9,9,9,9,9,9,9,9,9,9,9,9,9,9,9,
9,9,9,9,9,9,9,9,9,9,9,9,9,9,9,9,9,9,9,9,9,9,9,9,9,9,9,9,9,9,
9,9,9,9,9,9,9,9,9,9,9,9,9,9,9,9,9,9,9,9,9,9,9,9,9,9,9,9,9,9,
9,9,9,9,9,9,9,9,9,9,9,9,9,9,9,9,9,9,9,9,9,9,9,9,9,9,9,9,9,9,
9,9,9,9,9,9,9,9,9,9,9,9,9,9,9,9,9,9,9,9,9,9,9,9,9,9,9,9,9,9,
9,9,9,9,9,9,9,9,9,9,9,9,9,9,9,9,9,9,9,9,9,9,9,9,9,9,9,9,9,9,
9,9,9,9,9,9,9,9,9,9,9,9,9,9,9,9,9,9,9,9,9,9,9,9,9,9,9,9,9,9,
9,9,9,9,9,9,9,9,9,9,9,9,9,9,9,9,9,9,9,9,9,9,9,9,9,9,9,9,9,9,
9,9,9,9,9,9,9,9,9,9,9,9,9,9,9,9,9,9,9,9,9,9,9,9,9,9,9,9,9,9,
9,9,9,9,9,9,9,9,9,9,9,9,9,9,9,9,9,9,9,9,9,9,9,9,9,9,9,9,9,9,
9,9,9,9,9,9,9,9,9,9,9,9,9,9,9,9,9,9,9,9,9,9,9,9,9,9,9,9,9,9,
9,9,9,9,9,9,9,9,9,9,9,9,9,9,9,9,9,9,9,9,9,9,9,9,9,9,9,9,9,9,
9,9,9,9,9,9,9,9,9,9,9,9,9,9,9,9,9,9,9,9,9,9,9,9,9,9,9,9,9,9,
9,9,9,9,9,9,9,9,9,9,9,9,9,9,9,9,9,9,9,9,9,9,9,9,9,9,9,9,9,9,
9,9,9,9,9,9,9,9,9,9,9,9,9,9,9,9,9,9,9,9,9,9,9,9,9,9,9,9,9,9,
9,9,9,9,9,9,9,9,9,9,9,9,9,9,9,9,9,9,9,9,9,9,9,9,9,9,9,9,9,9,
9,9,9,9,9,9,9,9,9,9,9,9,9,9,9,9,9,9,9,9,9,9,9,9,9,9,9,9,9,9,
9,9,9,9,9,9,9,9,9,9,9,9,9,9,9,9,9,9,9,9,9,9,9,9,9,9,9,9,9,9,
9,9,9,9,9,9,9,9,9,9,9,9,9,9,9,9,9,9,9,9,9,9,9,9,9,9,9,9,9,9,
9,9,9,9,9,9,9,9,9,9,9,9,9,9,9,9,9,9,9,9,9,9,9,9,9,9,9,9,9,9,
9,9,9,9,9,9,9,9,9,9,9,9,9,9,9,9,9,9,9,9,9,9,9,9,9,9,9,9,9,9,
9,9,9,9,9,9,9,9,9,9,9,9,9,9,9,7,9,9,9,9,9,9,9,9,9,9,9,9,9,9,
9,9,9,9,9,9,9,9,9,9,9,9,9,1,7,1,8,6,9,9,9,9,9,9,9,9,9,9,9,9,
9,9,9,9,9,9,9,9,9,9,9,9,9,7,1,8,1,8,9,9,9,9,9,9,9,9,9,9,9,9,
9,9,9,9,9,9,9,9,9,9,9,9,9,8,1,7,7,8,9,9,9,9,9,9,9,9,9,9,9,9,
9,9,9,9,9,9,9,9,9,9,9,9,9,8,1,1,1,7,9,9,9,9,9,9,9,9,9,9,9,9,
9,9,9,9,9,9,9,9,9,9,9,9,9,9,9,9,9,9,9,9,9,9,9,9,9,9,9,9,9,9
5,5,5,5,5,5,5,5,5,5,5,5,5,5,5,5,5,5,5,5,1,7,8,7,5,5,5,5,5,5,
5,0,0,0,0,5,0,0,0,0,0,0,5,0,0,0,0,0,7,0,0,0,0,0,0,0,0,0,0,5,
5,0,0,0,0,1,0,0,0,0,0,0,5,0,0,0,0,0,6,0,0,0,0,0,0,0,0,0,0,1,
5,0,0,0,0,1,0,0,0,0,0,0,0,0,0,0,0,0,5,0,0,0,0,0,0,0,0,0,0,6,
5,0,0,0,0,5,0,0,0,0,0,0,5,0,0,0,0,0,5,0,0,0,0,0,0,0,0,0,0,5,
5,7,5,0,5,5,5,5,5,5,5,5,8,8,5,5,0,5,5,5,6,8,5,5,0,5,6,8,5,5,
5,0,0,0,0,0,0,0,0,0,0,0,0,0,0,0,0,0,0,0,0,0,0,0,0,0,0,0,0,5,
5,0,0,0,0,0,0,0,0,0,0,0,0,0,0,0,0,0,0,0,0,0,0,0,0,0,0,0,0,5,
5,5,8,6,5,5,5,0,0,5,5,5,5,5,5,5,5,5,6,8,8,5,5,5,5,5,0,5,5,5,
5,0,0,0,0,0,5,0,0,5,5,2,2,0,0,0,0,0,0,0,0,0,5,0,0,0,0,0,0,5,
5,0,0,0,0,0,5,0,0,2,1,1,0,0,0,0,0,0,0,0,0,0,5,0,0,0,0,0,0,1,
5,0,0,0,0,0,0,0,0,3,7,0,0,0,0,0,0,0,0,0,0,0,0,0,0,0,0,0,0,5,
7,0,0,0,0,0,5,0,0,4,1,1,0,0,0,0,0,0,0,0,0,0,5,0,0,0,0,0,0,5,
8,0,0,0,0,0,5,0,0,5,5,2,2,0,0,0,0,0,0,0,0,0,5,0,0,0,0,0,0,5,
5,5,5,7,7,6,5,0,0,5,5,2,3,4,5,5,5,5,8,6,1,5,5,0,0,0,0,0,0,5,
5,0,0,0,0,0,0,0,0,0,0,0,0,0,0,0,5,0,0,0,0,0,5,0,0,0,0,0,0,5,
5,0,0,0,0,0,0,0,0,0,0,0,0,0,0,0,5,0,0,0,0,0,5,5,5,5,8,8,5,5,
5,5,5,5,8,6,7,5,5,0,5,5,8,5,5,0,5,0,0,0,0,0,5,0,0,0,0,0,0,5,
5,0,0,0,0,0,0,0,1,0,0,0,0,5,8,0,6,5,0,0,0,0,5,0,0,0,0,0,0,5,
5,0,0,0,0,0,0,0,5,0,0,0,0,6,0,0,0,7,5,5,5,0,5,0,0,0,0,0,0,5,
5,0,0,0,0,0,0,0,0,0,0,0,0,0,0,0,0,0,0,0,0,0,0,0,0,0,0,0,0,5,
5,5,5,5,0,5,7,5,5,5,5,5,5,6,0,0,0,8,5,5,5,0,5,0,0,0,0,0,0,5,
5,0,0,0,0,0,0,0,0,0,0,0,5,5,8,0,1,5,0,0,5,0,5,0,0,0,0,0,0,5,
5,0,0,0,0,0,0,0,0,0,0,0,5,0,5,0,5,0,0,0,5,0,5,0,0,0,0,0,0,5,
5,0,0,0,0,0,0,0,0,0,0,0,1,1,1,0,8,1,7,5,5,0,5,5,5,7,5,5,5,5,
7,0,0,0,0,0,0,0,0,0,0,0,8,0,0,0,0,0,8,0,0,0,0,0,0,0,0,0,0,5,
5,0,0,0,0,0,0,0,0,0,0,0,7,0,0,0,0,0,7,0,0,0,0,0,0,0,0,0,0,8,
5,0,0,0,0,0,0,0,0,0,0,0,6,0,0,0,0,0,1,0,0,0,0,0,0,0,0,0,0,6,
5,0,0,0,0,0,0,0,0,0,0,0,7,0,0,0,0,0,6,0,0,0,0,0,0,0,0,0,0,5,
5,5,5,6,8,8,8,5,5,5,5,5,6,6,8,6,8,7,8,5,5,5,5,5,7,1,5,5,5,5
0,0,0,0,0,0,0,0,0,0,0,0,0,0,0,0,0,0,0,0,0,0,0,0,0,0,0,0,0,0,
0,0,0,0,0,0,0,0,0,0,0,0,0,0,0,0,0,0,0,0,0,0,0,2,0,0,0,0,0,0,
0,0,0,0,0,0,0,0,0,0,0,0,0,0,3,0,6,0,0,3,0,0,0,0,0,0,1,0,0,0,
0,0,0,1,0,0,0,0,0,1,0,0,0,0,0,4,0,0,0,0,0,3,0,0,0,0,0,0,0,0,
0,0,0,0,0,0,0,0,0,0,0,0,0,0,0,0,0,0,0,0,0,0,0,0,0,0,0,0,0,0,
0,0,0,0,0,0,0,0,0,0,0,0,0,0,0,0,0,0,0,0,0,0,0,0,0,0,0,0,0,0,
0,0,0,2,0,0,0,0,0,0,0,0,0,0,0,0,0,0,0,0,0,0,0,0,0,0,0,0,0,0,
0,0,0,0,0,0,0,0,6,0,0,0,0,0,0,0,0,0,7,0,0,0,0,5,0,0,7,0,0,0,
0,0,0,0,0,0,0,0,0,0,0,0,0,0,0,0,0,0,0,0,0,0,0,0,0,0,0,0,0,0,
0,0,0,0,0,0,0,0,0,0,0,0,0,0,0,0,0,0,0,0,0,0,0,0,0,0,0,0,0,0,
0,0,0,0,0,0,0,0,0,0,0,0,0,4,0,0,0,1,0,0,0,0,0,0,0,0,3,0,0,0,
0,0,0,1,0,0,0,0,0,0,0,0,0,0,0,0,0,0,0,0,6,0,0,0,0,0,0,0,0,0,
0,0,0,0,0,0,0,0,0,0,0,0,0,0,0,6,0,0,0,0,0,0,0,0,5,0,1,0,0,0,
0,0,0,0,0,0,0,0,0,0,0,0,0,0,0,0,0,0,0,0,0,0,0,0,0,0,0,0,0,0,
0,0,0,0,0,0,0,0,0,0,0,0,0,0,0,0,0,0,0,0,0,0,0,0,0,0,0,0,0,0,
0,0,0,0,0,0,0,1,0,0,0,0,0,0,0,0,0,0,0,0,0,0,0,0,0,0,0,0,0,0,
0,0,0,0,0,0,0,0,0,0,0,0,0,5,0,0,0,0,0,6,0,0,0,0,0,0,0,0,0,0,
0,0,0,0,0,0,0,0,0,0,0,0,0,0,0,0,0,0,0,0,0,0,0,0,0,0,0,0,0,0,
0,0,0,0,0,0,0,0,0,5,0,0,0,0,0,0,0,0,0,0,0,0,0,0,3,0,0,0,0,0,
0,0,0,0,0,1,0,0,0,0,0,0,0,0,0,0,0,0,0,0,0,0,0,5,0,0,0,0,0,0,
0,0,0,0,0,0,0,0,0,0,0,5,0,0,0,1,0,0,0,0,0,0,0,0,0,1,0,4,0,0,
0,0,0,0,0,0,0,0,0,0,0,0,0,0,0,0,0,0,0,0,0,0,0,0,0,0,0,0,0,0,
0,0,0,0,0,0,0,0,0,0,0,0,0,0,0,0,0,0,0,0,0,0,0,0,0,0,0,3,0,0,
0,0,0,0,0,0,3,0,0,0,0,0,0,0,0,0,0,0,0,0,0,0,0,0,0,0,0,0,0,0,
0,0,3,0,0,0,0,0,0,0,0,0,0,0,0,0,0,0,0,0,0,0,0,0,0,0,0,0,0,0,
0,0,0,0,0,0,0,0,0,0,0,0,0,0,0,0,0,0,0,0,0,0,0,0,0,0,0,0,0,0,
0,0,0,1,0,0,4,0,0,1,0,0,0,0,0,0,0,0,0,0,4,0,0,0,0,0,0,6,0,0,
0,0,0,0,0,0,0,0,0,0,0,0,0,0,0,0,0,0,0,0,0,0,0,0,0,0,1,0,0,0,
0,0,0,0,0,0,0,0,0,2,0,0,0,0,0,0,0,0,0,0,0,0,3,0,0,0,0,0,0,0,
0,0,0,0,0,0,0,0,0,0,0,0,0,0,0,0,0,0,0,0,0,0,0,0,0,0,0,0,0,0
9,6,9,9,9,9,9,9,9,7,9,9,9,9,9,1,9,9,9,9,9,6,9,9,9,9,9,9,9,9,
9,9,7,9,9,9,9,9,9,9,9,9,9,9,9,9,9,9,9,9,9,9,9,9,9,7,9,9,9,9,
9,9,9,9,9,1,9,9,9,9,9,9,6,9,7,7,9,6,1,9,9,6,9,9,9,9,9,9,9,6,
9,9,9,8,9,7,9,9,9,9,9,9,9,9,9,8,9,9,9,9,9,9,9,9,9,9,9,9,9,9,
9,9,9,8,9,9,9,9,8,6,9,9,9,9,9,9,9,9,9,6,9,9,1,8,9,9,9,9,7,9,
9,9,9,9,9,9,9,8,9,9,9,1,9,9,9,9,9,9,9,9,9,9,6,9,9,9,9,9,7,9,
9,1,1,9,9,9,9,9,9,9,9,9,9,9,9,9,9,7,6,9,9,9,9,9,9,9,9,8,1,1,
9,9,9,8,9,9,9,9,9,7,9,9,9,9,1,9,9,9,9,9,9,9,9,9,9,9,1,9,6,9,
1,6,9,9,9,9,9,9,9,8,9,9,9,9,1,9,9,9,9,1,6,9,1,9,9,9,9,9,9,9,
9,1,7,9,9,9,9,9,9,8,9,9,9,9,9,9,6,9,9,9,9,9,9,9,9,9,9,9,9,9,
9,9,9,6,9,9,6,9,9,9,9,9,9,9,9,9,9,9,9,9,9,7,9,9,9,9,9,9,9,9,
9,9,9,8,9,9,9,9,1,9,6,9,9,1,9,9,9,9,9,9,9,8,7,9,9,9,9,7,9,7,
9,9,9,9,9,9,9,9,9,8,9,9,9,9,9,9,9,9,9,9,9,9,9,9,6,9,9,9,9,9,
7,7,9,9,9,9,9,9,1,7,9,9,9,9,9,9,9,9,9,9,9,9,9,9,9,9,9,9,9,9,
9,9,9,9,9,8,9,9,9,9,9,9,9,9,9,1,9,9,9,9,1,9,9,9,9,9,9,9,9,9,
9,8,9,9,9,9,9,9,7,9,9,9,9,9,9,9,9,9,9,9,9,9,9,9,9,9,9,9,9,9,
8,1,9,9,9,9,9,9,9,9,9,9,8,9,9,9,9,1,9,1,9,9,9,1,9,9,9,9,9,9,
9,9,9,9,9,9,9,1,9,9,9,6,9,9,9,9,9,6,9,9,1,6,7,8,9,1,9,9,7,6,
9,9,6,9,9,9,9,9,8,9,9,9,9,9,9,8,9,9,9,6,9,9,9,9,9,8,9,9,9,9,
9,9,9,9,9,9,9,9,9,9,9,9,9,7,9,9,9,9,9,9,7,9,9,9,9,9,9,9,6,9,
9,6,9,9,9,9,9,9,9,9,9,9,9,9,9,9,9,9,9,6,9,9,9,9,8,9,9,9,9,9,
1,9,9,9,9,9,1,9,9,9,9,9,9,9,9,9,1,9,6,7,9,6,8,9,9,7,9,9,9,9,
9,9,9,9,9,1,9,9,9,9,9,7,9,9,9,9,9,9,9,9,6,9,9,9,9,9,9,7,9,9,
9,9,9,1,9,9,9,8,9,9,9,9,9,9,6,9,9,9,9,9,9,9,9,9,9,9,9,9,9,9,
9,9,9,6,9,9,9,9,9,9,9,9,8,7,8,7,1,8,7,9,9,9,9,9,6,9,9,9,9,9,
8,9,8,9,9,9,9,9,9,9,9,1,8,7,1,6,7,1,6,9,9,1,9,9,9,9,9,9,9,9,
9,9,9,8,9,9,9,9,1,9,9,9,1,6,1,8,7,6,6,9,9,8,9,1,8,9,9,9,9,9,
7,9,9,9,9,9,1,9,9,9,6,9,8,7,8,8,8,8,7,9,7,9,9,7,6,9,9,9,6,9,
9,1,9,9,8,9,7,9,9,9,9,7,8,8,7,1,7,7,1,9,9,7,9,9,9,8,9,7,9,9,
9,9,9,9,9,9,9,9,9,8,9,9,8,8,6,1,1,8,8,8,9,9,9,9,9,6,9,9,9,9